S1000000000000000000
11111111111111111110
11111111111111111110
11111111111111111110
11111111111111111110
11111111111111111110
01000000000000000010
01111111111111111111
01111111111111111111
01111111111111111111
01111111111111111111
0111111111111111111E
00000000000000000000
