
555555555555555555
11666666666
11111111111111111110
5555555555555555555
11111111111111111110
00000000000000000000
01111111111111111111
55555
01111111111111111111
66666
01111111111111111111
00000000000000000000
